##########
#X.......#
#@.....@.#
#........#
#*.....*.#
##########